111111111111111111111111111111
100000000000001100000000000001
101111101111101101111101111101
101111101111101101111101111101
100000000000000000000000000001
101111101101111111101101111101
101111101101111111101101111101
100000001100001100001100000001
101111011111101101111110111101
101111011111101101111110111101
101111001100000000001100111101
101111101101111111101101111101
101111100001111111100001111101
111111101101110011101101111111
111111101100000000001101111111
100001101101111111101101100001
101101101101111111101101101101
101101101100001100001101101101
100001100001101101100001100001
101111101111101101111101111101
101111101111101101111101111101
100000000000001100000000000001
101111101111101101111101111101
101111101111101101111101111101
100000000000000000000000000001
111111111111111111111111111111